-16
16
-7
7
000000000000000000000000000000000
000000000000000000000000000000000
000000000000000000000000000000000
000000000000000000000000000000000
000000000000000000011111110000000
000000000000000000011111110000000
000001000000000000011111110000000
000000000000000000011111110000000
000000010000000000011111110000000
000000000000000000011111110000000
000000000000000001111111110000000
000000000000000000000000000000000
000000000000000000000000000000000
000000000000000000000000000000000
000000000000000000000000000000000
